5 13 31
###############################
#p x *3       *  ** * *      *#
# # # # #*# # #*# # # # # #*# #
#    * * *** **  5   *    **  #
# #*# # # # #4# #b#1# # # # #*#
#          *     **      *  **#
# # #*# # # # # #*#*#*#*# # # #
#   *        *   * * * *   4  #
# # # # #*# # # # # # #*# #*# #
#   ****         *2           #
# # # # # # # # # #*# # # # #*#
#  ** *5  *    2              #
###############################